"XXXXSXXXX",
"X XX XXXX",
"X XX XXXX",
"X XX XXXX",
"X    XXXX",
"XXXX XXXX",
"XXXX XXXX",
"X       X",
"XXXXXXXCX",
